. . . . . . . . . . . . . . . . . . . . . . . . .
. . . . . . . . . . . . . . . . . . . . . . . . .
. . . . . . . . . . . . . . . . . . . . . . . . .
. . . . . . . . . . . . . . . . . . . . . . . . .
. . . . . . . . . . . . . . . . . . . . . . . . .
. . . . # # # # # # . . . . . . # # # # # # # . .
. . . . # # # # # # . . . . . . # # # # # # # . .
. . . . # # # # # # . . . . . . # # # # # # # . .
. . . . # # # # # # . . . . . . # # # # # # # . .
. . . . . . . . . . # # # # # # . . . . . . . . .
. . . . . . . . . . # # # # # # . . . . . . . . .
. . . . . . . . . . # # # # # # . . . . . . . . .
. . . . . . . . . . # # # # # # . . . . . . . . .
. . . . . . . . . . # # # # # # . . . . . . . . .
. . . . . . . . . . # # # # # # . . . . . . . . .
. . . . . . . . . . . . . . . . . . . . . . . . .
. . . . . . . . . . . . . . . . . . . . . . . . .
. . . . . . . . . . . . . . . . . . . . . . . . .
. . . . . . . . . . . . . . . . . . . . . . . . .
. . . . . . . . . . . . . . . . . . . . . . . . .
. . . . . . . . . . . . . . . . . . . . . . . . .
. . . . . . . . . . . . . . . . . . . . . . . . .
. . . . . . . . . . . . . . . . . . . . . . . . .
. . . . . . . . . . . . . . . . . . . . . . . . .
. . . . . . . . . . . . . . . . . . . . . . . . .
